##########
#S.......#
#.#.###..#
#...#...##
###.#.####
#...#...E#
##########
